63 63 63 63 63 63 63 63 63 63 63 63 63 63 63 63 63 63 63 63 63 63 63 63 63 63 63 63 63 63 63 63 63 63 63 63 63 63 63 63 63 63 63 63 63 63 63 63 63 63 
63 63 63 63 63 63 63 63 63 63 63 63 63 63 63 63 63 63 63 63 63 63 10 4 4 3 4 4 3 4 15 63 63 63 63 63 63 63 63 63 63 63 63 63 63 63 63 63 63 63 
63 63 63 63 63 63 63 63 63 63 63 63 63 63 63 63 63 63 63 63 63 63 10 64 64 64 64 64 64 56 15 63 63 63 63 63 63 63 63 63 63 63 63 63 63 63 63 63 63 63 
63 63 63 63 63 63 63 63 63 63 63 63 63 63 63 63 63 63 63 63 63 63 10 64 22 64 64 64 9 64 15 63 63 63 63 63 63 63 63 63 63 63 63 63 63 63 63 63 63 63 
63 63 63 63 63 63 63 63 63 63 63 63 63 63 63 63 63 63 63 63 63 63 10 64 7 64 64 6 7 64 15 63 63 63 63 63 63 63 63 63 63 63 63 63 63 63 63 63 63 63 
63 63 63 63 63 63 63 63 63 63 63 63 63 63 63 63 63 63 63 63 63 63 10 64 64 64 29 64 64 64 15 63 63 63 63 63 63 63 63 63 63 63 63 63 63 63 63 63 63 63 
63 63 63 63 63 63 63 63 63 63 63 63 63 63 63 63 63 63 63 63 63 63 10 64 64 64 64 64 64 64 15 63 63 63 63 63 63 63 63 63 63 63 63 63 63 63 63 63 63 63 
63 63 63 63 63 63 63 63 63 63 63 63 63 63 63 63 63 63 63 63 63 63 10 64 22 64 64 64 6 64 15 63 63 63 63 63 63 63 63 63 63 63 63 63 63 63 63 63 63 63 
63 63 63 63 63 63 63 63 63 63 63 63 63 63 63 63 63 63 63 63 63 63 10 54 64 64 64 64 64 64 15 63 63 63 63 63 63 63 63 63 63 63 63 63 63 63 63 63 63 63 
63 63 63 63 63 63 63 63 63 63 63 63 63 63 63 63 63 63 63 63 63 63 36 37 46 58 64 43 40 40 41 63 63 63 63 63 63 63 63 63 63 63 63 63 63 63 63 63 63 63 
63 63 63 63 63 63 63 63 63 63 63 63 63 63 63 63 63 63 63 63 63 63 63 63 10 64 59 15 63 63 63 63 63 63 63 63 63 63 63 63 63 63 63 63 63 63 63 63 63 63 
63 63 63 63 63 63 63 63 63 63 63 63 63 63 63 63 63 63 63 63 63 63 10 1 1 64 64 1 1 1 35 63 63 63 63 63 63 63 63 63 63 63 63 63 63 63 63 63 63 63 
63 63 63 63 63 63 63 63 63 63 63 63 63 63 63 63 63 63 63 63 63 63 10 56 64 64 64 64 64 62 35 63 63 63 63 63 63 63 63 63 63 63 63 63 63 63 63 63 63 63 
63 63 63 63 63 63 63 63 63 63 63 63 63 63 63 63 63 63 63 63 63 63 10 64 17 64 64 58 17 64 35 63 63 63 63 63 63 63 63 63 63 63 63 63 63 63 63 63 63 63 
63 63 63 63 63 63 63 63 63 63 63 63 63 63 63 63 63 63 63 63 63 63 10 64 58 27 29 64 8 64 35 63 63 63 63 63 63 63 63 63 63 63 63 63 63 63 63 63 63 63 
63 63 63 63 63 63 63 63 63 63 63 63 63 63 63 63 63 63 63 63 63 63 10 64 64 64 64 64 64 64 35 63 63 63 63 63 63 63 63 63 63 63 63 63 63 63 63 63 63 63 
63 63 63 63 63 63 63 63 63 63 63 63 63 63 63 63 63 63 63 63 63 63 10 64 26 27 64 9 29 64 35 63 63 63 63 63 63 63 63 63 63 63 63 63 63 63 63 63 63 63 
63 63 63 63 63 63 63 63 63 63 63 63 63 63 63 63 63 63 63 63 63 63 10 64 64 64 59 64 64 64 35 63 63 63 63 63 63 63 63 63 63 63 63 63 63 63 63 63 63 63 
63 63 63 63 63 63 63 63 63 63 63 63 63 63 63 63 63 63 63 63 63 63 10 64 64 64 64 64 64 55 35 63 63 63 63 63 63 63 63 63 63 63 63 63 63 63 63 63 63 63 
63 63 63 63 63 63 63 63 63 63 63 63 63 63 63 63 63 63 63 63 63 63 36 37 46 59 64 43 37 37 41 63 63 63 63 63 63 63 63 63 63 63 63 63 63 63 63 63 63 63 
63 63 63 63 63 63 63 63 63 63 63 63 63 63 63 63 63 63 63 63 63 63 63 63 10 64 64 15 63 63 63 63 63 63 63 63 63 63 63 63 63 63 63 63 63 63 63 63 63 63 
63 63 10 3 4 2 4 2 3 2 15 63 10 1 1 1 1 1 1 1 15 63 10 1 1 64 64 1 2 1 15 63 10 3 3 2 1 1 2 1 15 63 63 63 63 63 63 63 63 63 
63 63 10 17 58 64 64 26 29 29 15 63 10 54 64 64 64 64 64 55 15 63 10 64 58 64 64 64 64 56 15 63 10 64 64 9 7 64 64 55 15 63 63 63 63 63 63 63 63 63 
63 63 10 18 17 60 64 64 18 18 15 63 10 6 64 64 8 27 64 64 15 63 10 64 60 64 64 61 6 64 15 63 10 64 64 64 64 64 64 64 15 63 63 63 63 63 63 63 63 63 
63 63 10 18 60 18 18 9 64 18 4 3 4 64 64 64 29 64 64 64 3 3 4 64 61 64 64 64 64 64 4 4 3 64 9 17 64 7 6 64 15 63 63 63 63 63 63 63 63 63 
63 63 10 18 64 9 18 18 64 58 18 64 58 64 26 64 8 64 64 64 64 64 58 64 64 8 58 64 64 64 6 64 64 64 64 64 64 64 64 64 15 63 63 63 63 63 63 63 63 63 
63 63 10 18 64 18 9 64 64 64 18 64 64 64 6 64 64 64 64 28 64 64 64 64 64 64 64 64 17 64 64 8 6 64 6 26 64 17 64 64 15 63 63 63 63 63 63 63 63 63 
63 63 10 18 28 8 64 64 64 64 43 44 46 64 64 27 59 64 64 64 43 37 46 64 6 64 64 8 64 64 43 40 46 64 26 64 64 58 59 64 15 63 63 63 63 63 63 63 63 63 
63 63 10 18 18 18 18 18 28 17 15 63 10 54 64 64 64 64 59 16 15 63 10 54 64 64 64 64 64 18 15 63 10 62 64 64 64 64 64 55 15 63 63 63 63 63 63 63 63 63 
63 63 36 37 37 37 37 37 40 37 41 63 36 37 46 64 64 47 37 37 41 63 36 40 46 64 64 43 37 37 41 63 36 37 37 37 37 37 37 37 41 63 63 63 63 63 63 63 63 63 
63 63 63 63 63 63 63 63 63 63 63 63 63 63 10 64 8 15 63 63 63 63 63 63 10 28 64 15 63 63 63 63 63 63 63 63 63 63 63 63 63 63 63 63 63 63 63 63 63 63 
63 63 63 63 63 63 63 63 63 63 63 63 10 4 4 64 64 3 4 4 15 63 10 4 4 6 64 4 3 3 15 63 10 4 4 4 3 2 1 1 15 63 63 63 63 63 63 63 63 63 
63 63 63 63 63 63 63 63 63 63 63 63 10 56 64 64 64 27 64 62 15 63 10 54 64 64 64 64 64 64 15 63 10 62 64 64 64 64 17 55 15 63 63 63 63 63 63 63 63 63 
63 63 63 63 63 63 63 63 63 63 63 63 10 64 64 60 64 64 27 64 15 63 10 64 6 64 64 19 17 64 15 63 10 64 58 64 17 64 64 64 15 63 63 63 63 63 63 63 63 63 
63 63 63 63 63 63 63 63 63 63 63 63 10 64 64 64 26 64 59 64 15 63 10 64 64 27 64 64 19 64 4 3 4 64 64 64 64 64 64 64 15 63 63 63 63 63 63 63 63 63 
63 63 63 63 63 63 63 63 63 63 63 63 10 64 6 64 27 64 64 64 15 63 10 64 64 64 64 64 64 64 64 19 64 64 64 27 6 64 60 64 15 63 63 63 63 63 63 63 63 63 
63 63 63 63 63 63 63 63 63 63 63 63 10 64 64 64 27 64 64 64 15 63 10 64 26 64 64 64 64 64 64 64 58 64 64 64 26 64 64 64 15 63 63 63 63 63 63 63 63 63 
63 63 63 63 63 63 63 63 63 63 63 63 10 64 64 59 64 64 58 64 15 63 10 64 64 27 64 58 27 64 43 44 46 64 17 60 64 64 64 64 15 63 63 63 63 63 63 63 63 63 
63 63 63 63 63 63 63 63 63 63 63 63 10 64 64 64 64 64 64 56 15 63 10 64 64 64 64 64 64 56 15 63 30 54 64 64 64 64 64 58 15 63 63 63 63 63 63 63 63 63 
63 63 63 63 63 63 63 63 63 63 63 63 36 40 40 40 40 40 40 40 41 63 36 40 40 40 40 40 40 40 41 63 36 40 40 40 40 40 40 40 41 63 63 63 63 63 63 63 63 63 
63 63 63 63 63 63 63 63 63 63 63 63 63 63 63 63 63 63 63 63 63 63 63 63 63 63 63 63 63 63 63 63 63 63 63 63 63 63 63 63 63 63 63 63 63 63 63 63 63 63 
63 63 63 63 63 63 63 63 63 63 63 63 63 63 63 63 63 63 63 63 63 63 63 63 63 63 63 63 63 63 63 63 63 63 63 63 63 63 63 63 63 63 63 63 63 63 63 63 63 63 
63 63 63 63 63 63 63 63 63 63 63 63 63 63 63 63 63 63 63 63 63 63 63 63 63 63 63 63 63 63 63 63 63 63 63 63 63 63 63 63 63 63 63 63 63 63 63 63 63 63 
63 63 63 63 63 63 63 63 63 63 63 63 63 63 63 63 63 63 63 63 63 63 63 63 63 63 63 63 63 63 63 63 63 63 63 63 63 63 63 63 63 63 63 63 63 63 63 63 63 63 
63 63 63 63 63 63 63 63 63 63 63 63 63 63 63 63 63 63 63 63 63 63 63 63 63 63 63 63 63 63 63 63 63 63 63 63 63 63 63 63 63 63 63 63 63 63 63 63 63 63 
63 63 63 63 63 63 63 63 63 63 63 63 63 63 63 63 63 63 63 63 63 63 63 63 63 63 63 63 63 63 63 63 63 63 63 63 63 63 63 63 63 63 63 63 63 63 63 63 63 63 
63 63 63 63 63 63 63 63 63 63 63 63 63 63 63 63 63 63 63 63 63 63 63 63 63 63 63 63 63 63 63 63 63 63 63 63 63 63 63 63 63 63 63 63 63 63 63 63 63 63 
63 63 63 63 63 63 63 63 63 63 63 63 63 63 63 63 63 63 63 63 63 63 63 63 63 63 63 63 63 63 63 63 63 63 63 63 63 63 63 63 63 63 63 63 63 63 63 63 63 63 
63 63 63 63 63 63 63 63 63 63 63 63 63 63 63 63 63 63 63 63 63 63 63 63 63 63 63 63 63 63 63 63 63 63 63 63 63 63 63 63 63 63 63 63 63 63 63 63 63 63 
63 63 63 63 63 63 63 63 63 63 63 63 63 63 63 63 63 63 63 63 63 63 63 63 63 63 63 63 63 63 63 63 63 63 63 63 63 63 63 63 63 63 63 63 63 63 63 63 63 63 
